111000000000000000000000000000
111000000000000000000000000000
111000000000000000000000000000
111200000000100000000000000000
111000000000000000000000000000
111200000000000000000000000000
111000000000000000000000000000
111000000000000000000000000000
111200000000000000000000000111
111000000000000000000000000000
111000000000000000000000000000
111000000000000000000000000000
111000000000000000000000000000
111000000000000000000000000000
111000000000000000000000000000
111200000000000000000000000000
111000000000000000000000000000
111000000000000000000000000000
111000000000000000000000000000
111000000000000000000000000000
111000000000000000000000000000
111000000000000000000000000000
111200000000000000000000000000
111000000000000000000000000000
111000000000000000000000000000
111000000000000000000000000000
111000000000000000000000000000
111000000000000000000000000000
111000000000000000000000000000
111000000000000000000000000000