111000000000000000000000000000
111000000000000000000000000000
111000000000000000000000000000
111200000000000000000000000000
111000000000000000000000000000
111200000000000000000000000000
111000000000000000000000000000
111000000000000000000000000000
000000000000000000000000000000
000000000000000000000000000000
000000000000000000000000000000
111000000000000000000000000000
111000000000000000000000000000
111000000000000000000000000000
111000000000000000000000000000
111200000000000000000000000000
111000000000000000000000000000
111000000000000000000000000000
111000000000000000000000000000
111000000000000000000000000000
111000000000000000000000000000
111000000000000000000000000000
111200000000000000000000000000
111000000000000000000000000000
111000000000000000000000000000
111000000000000000000000000000
111000000000000000000000000000
111000000000000000000000000000
111000000000000000000000000000
111000000000000000000000000000